,,,,,,,,,,,,,,,,,,,,,,,,,,,,,,,
,,,,,,,,,,,,,,xxx,,,,,,,,,,,,,,,
,,,,,,,,,,,,,,xxx,,,,,,,,,,,,,,,
,,,,,,,,,,,,,,xxx,,,,,,,,,,,,,,,
,,,,,,,,,,,,,,xxx,,,,,,,,,,,,,,,
,,,,,,,,,,,,,,xxx,,,,,,,,,,,,,,,
,,,,,,,,,,,,,,xxx,,,,,,,,,,,,,,,
,,,,,,,,,,,,,,xxx,,,,,,,,,,,,,,,
,,,,,,,,,,,,,,xxx,,,,,,,,,,,,,,,
,,,,,,,,,,,,,,xxx,,,,,,,xxxxxxxxx
,,,,,,,,,,,,,,xxx,,,,,,,xxxxxxxxx
,,,,,,,,,,,,,,xxx,,,,,,,xxxxxxxxx
,,,,,,,,,,,,,,xxx,,,,,,,,,,,,,,,
,,,,,,,,,,,,,,xxx,,,,,,,,,,,,,,,
,,,,,,xxx,,,,,xxx,,,,,,,,,,,,,,,
,,,,,,xxx,,,,,xxx,,,,,,,,,,,,,,,
,,,,,,xxx,,,,,xxx,,,,,,,,,,,,,,,
,,,,,,xxx,,,,,xxx,,,,,,,,,,,,,,,
,,,,,,xxx,,,,,xxx,,,,,,,,,,,,,,,
,,,,,,xxx,,,,,xxxxxxxxxxx,,,,,,,
,,,,,,xxx,,,,,xxxxxxxxxxx,,,,,,,
,,,,,,xxx,,,,,xxxxxxxxxxx,,,,,,,
,,,,,,xxx,,,,,,,,,,,,,,,,,,,,,,,
,,,,,,xxx,,,,,,,,,,,,,,,,,,,,,,,
,,,,,,xxx,,,,,,,,,,,,,,,,,,,,,,,
,,,,,,xxx,,,,,,,,,,,,,,,,,,,,,,,
,,,,,,xxx,,,,,,,,,,,,,,,,,,,,,,,
,,,,,,xxx,,,,,,,,,,,,,,,,,,,,,,,
,,,,,,xxx,,,,,,,,,,,,,,,,,,,,,,,
,,,,,,xxx,,,,,,,,,,,,,,,,,,,,,,,
,,,,,,xxx,,,,,,,,,,,,,,,,,,,,,,,
,,,,,,xxx,,,,,,,,,,,,,,,,,,,,,,,
,,,,,,xxx,,,,,,,,,,,,,,,,,,,,,,,
,,,,,,xxx,,,,,,,,,,,,,,,,,,,,,,,
,,,,,,xxx,,,,,,,,,,,,,,,,,,,,,,,
,,,,,,xxx,,,,,,,,,,,,,,,,,,,,,,,
,,,,,,xxx,,,,,,,,,,,,,,,,,,,,,,,

